wwwwwwwwwwwwwwwwwwwww
w#....w.....w.....w.w
w.w.wwwww.w.www.www.w
w.w.w...w.w.....w...w
www.www.w.www.w.w.w.w
w.w.........w.w...w.w
w.www.w.w.wwwwwww.w.w
w.w.w.w.w...w.w.w.w.w
w.w.www.wwwww.w.w.www
w...w.......w.w.....w
w.w.w.www.www.w.www.w
w.w.w...w...w.w.w.w.w
w.wwwww.wwwww.www.www
w...w.w...w.w.......w
w.www.www.w.w.www.www
w.w.w...w...w.w.....w
w.w.www.w.wwwwwww.www
w.w.........w...w...w
w.www.wwwwwwwww.w.www
w..................,w
wwwwwwwwwwwwwwwwwwwww
